[openbb_core_extension]
commodity=openbb_commodity.commodity_router:router
crypto=openbb_crypto.crypto_router:router
currency=openbb_currency.currency_router:router
derivatives=openbb_derivatives.derivatives_router:router
econometrics=openbb_econometrics.econometrics_router:router
economy=openbb_economy.economy_router:router
equity=openbb_equity.equity_router:router
etf=openbb_etf.etf_router:router
fixedincome=openbb_fixedincome.fixedincome_router:router
index=openbb_index.index_router:router
news=openbb_news.news_router:router
quantitative=openbb_quantitative.quantitative_router:router
regulators=openbb_regulators.regulators_router:router
technical=openbb_technical.technical_router:router

[openbb_obbject_extension]
openbb_charting=openbb_charting:ext

[openbb_provider_extension]
alpha_vantage=openbb_alpha_vantage:alpha_vantage_provider
benzinga=openbb_benzinga:benzinga_provider
biztoc=openbb_biztoc:biztoc_provider
bls=openbb_bls:bls_provider
cboe=openbb_cboe:cboe_provider
ecb=openbb_ecb:ecb_provider
econdb=openbb_econdb:econdb_provider
federal_reserve=openbb_federal_reserve:federal_reserve_provider
finra=openbb_finra:finra_provider
finviz=openbb_finviz:finviz_provider
fmp=openbb_fmp:fmp_provider
fred=openbb_fred:fred_provider
government_us=openbb_government_us:government_us_provider
intrinio=openbb_intrinio:intrinio_provider
multpl=openbb_multpl:multpl_provider
nasdaq=openbb_nasdaq:nasdaq_provider
oecd=openbb_oecd:oecd_provider
polygon=openbb_polygon:polygon_provider
sec=openbb_sec:sec_provider
seeking_alpha=openbb_seeking_alpha:seeking_alpha_provider
stockgrid=openbb_stockgrid:stockgrid_provider
tiingo=openbb_tiingo:tiingo_provider
tmx=openbb_tmx:tmx_provider
tradier=openbb_tradier:tradier_provider
tradingeconomics=openbb_tradingeconomics:tradingeconomics_provider
wsj=openbb_wsj:wsj_provider
yfinance=openbb_yfinance:yfinance_provider

